{
  "id": "graphite",
  "displayName": "그래파이트",
  "keys": {
    "-": "[",
    "=": "]",
    "q": "b",
    "w": "l",
    "e": "d",
    "r": "w",
    "t": "z",
    "y": "'",
    "u": "f",
    "i": "o",
    "o": "u",
    "p": "j",
    "[": ";",
    "]": "=",
    "a": "n",
    "s": "r",
    "d": "t",
    "f": "s",
    "h": "y",
    "j": "h",
    "k": "a",
    "l": "e",
    ";": "i",
    "'": ",",
    "z": "q",
    "c": "m",
    "v": "c",
    "b": "v",
    "n": "k",
    "m": "p",
    ",": ".",
    ".": "-"
  }
}
